NO ./textures/n.xpm
SO ./textures/s.xpm
WE ./textures/w.xpm
EA ./textures/e.xpm
F 80,160,90
C 135,206,235

1111111111
1N00000001
1011111101
1010000101
1010110101
1000100001
1110101111
1000000001
1011111111
1111111111
