NO ./textures/n.xpm
SO ./textures/s.xpm
WE ./textures/w.xpm
EA ./textures/e.xpm
F 91,255,87
C 200,200,200
11111111111111
1100000010001
11000000000011
11010100100001
1111011110W011
 101111010001
 111111111111
