NO ./textures/n.xpm
SO ./textures/s.xpm
WE ./textures/w.xpm
EA ./textures/e.xpm
F 91,255,87
C 200,200,200
111111
100001
100001
100001
100001
100001
10W001
111111
