NO ./textures/n.xpm
SO ./textures/s.xpm
WE ./textures/w.xpm
EA ./textures/e.xpm

F 80,160,90
C 135,206,235

1111111111111111111111111
1000000001100N00000000001
1011000001110000000000001
10010000000000000000000011111111
111111111011000001110000000000001
100000000011000001110111111111111
11110111111111011100000010001
11110111111111011101010010001
11000000110101011100000010001
10000000000000001100000000001
100000000000000011010100100001
11000001110101011111011110001
11110111 1110101 101111010001
11111111 1111111 111111111111
