NO ./textures/n.xpm
SO ./textures/s.xpm
WE ./textures/w.xpm
EA ./textures/e.xpm

F 91,255,870
C 200,200,000

11111111111111
1000000000000N001
11111111111111
